######################################
#....................................#
#..S...#......................#......#
#......#......................#......#
#.............................#......#
#....................................#
#....................................#
#..............#.....................#
#............#.......................#
#..........#.........................#
#....................................#
#.....................##########.#...#
#................................#...#
#.....................#..........#...#
#................................#.X.#
######################################